3 3
x=0   y=0   l=1   r=0   u=1   d=1   
x=0   y=1   l=0   r=0   u=1   d=1   
x=0   y=2   l=0   r=1   u=0   d=1   
x=1   y=0   l=1   r=1   u=0   d=1   
x=1   y=1   l=1   r=0   u=0   d=1   
x=1   y=2   l=0   r=1   u=1   d=0   
x=2   y=0   l=1   r=0   u=1   d=0   
x=2   y=1   l=0   r=0   u=1   d=0   
x=2   y=2   l=0   r=1   u=1   d=1   
